======================
=           #      ^ =
= ======#== ======== =
=         ===  % === =
=   @            *   =
=^          T    = **=
=====            = *%=
= W =         = != *X=
=  !          = == **=
=================!   =
=**= X=!============#=
=K*#    *           M=
======================
