=========================
=    X        *   K   #@=
=!      *  *          ##=
=    M        ^     %   =
==========#==============
= T F          *W*    X =
=***           ***      =
=%!*      ^   %*        =
=========================